1111111111
1000000000
1000000111
0000011111
1111111111